______________________________
|                            |
|                            |
|            #####           |
|                            |
|  #######          ####     |
|                            |
|                            |
|              ###########   |
|                            |
|                            |
|       #########            |
|                            |
|                            |
| ########                   |
|                            |
|          ###########       |
|                            |
|                            |
##############################