##############################
#                            #
#        ####                #
#                            #
#                   ####     #
#  #######                   #
#                            #
#                            #
#              ###########   #
#                            #
#                            #
#       #########            #
#                            #
#                            #
# #########                  #
#                            #
#          ###########       #
#                            #
#                            #
##############################