______________________________
|                            |
|        ####                |
|                            |
|                   ####     |
|  #######                   |
|                            |
|                            |
|              ###########   |
|                            |
|                            |
|       #########            |
|                            |
|                            |
| #########                  |
|                            |
|          ###########       |
|                            |
|                            |
##############################