______________________________
|                            |
|        ######              |
|                       #####|
|           wwww             |
|wwww       ####             |
|####                 wwwwww |
|        ######       ###### |
|                            |
|                 ####       |
|     #######                |
|                            |
|              ###########   |
|                            |
|                            |
|       #########            |
|                            |
|                   ######## |
| ########                   |
|                            |
|          ###########       |
|                            |
|                            |
|      #######          #### |
|                            |
|            #####           |
|    !                       |
|  #######          ####     |
|                            |
|                      !     |
|              ###########   |
|                            |
|          !                 |
|       #########            |
|            ;;;             |
|   ^^^                      |
| ########                   |
|       ;;   !               |
|          ###########       |
|                            |
|                            |
##############################
